1111111111
1P00000001
1011001101
1011001101
1000110001
1001111001
1001111001
10010010C1
10000000E1
1111111111
