1111111111111111111111111111111111111111111111111111
10010000000C0010000000C0010000000C001000E00000010001
10010000000000100C1000C001000000000010000M0000010001
1001000000001010010000C0010000000C000000000000000001
1001000000C00100110000C0010M00000000100M0000C0010001
1000000M00000010000000C0010000000C001000000000010C01
1C01000000000010000000000100000000001000000000010001
11110000000000111111100111000000000000000000C0011011
100000000000M00000000M000000000000000000000000000001
1000000000M00000000000000000000000000000000000000001
1111000000000011111011111000000000001111111111111111
10010000000C0010000000C0010000000C001000C00000010001
10010000000000100C1000C00100000M00001000000000010001
10M1000000001010010000C0010000M00C000000000000000001
1001000000C00100110P00C00100M000000010000000C0010001
1000000000000010000000C0010000000C00100M000000010C01
1C01000000000010000000C00100000000001000000000010001
1111000000000011111110C111000000000000000000C0011011
1111111111111111111111111111111111111111111111111111