111111111111111111111111111111111111
1000P00001000000010000C0001000C00001
10000000010000000100M000001000000001
100000000000000000000000001000000001
100C000001000000010000C0001M00000001
111111111100000001111111111111011111
100CC00110000000010C000000000M000C01
100M001100000000010C0000000000000C01
1000011000000000010C0000000000000C01
111011000000000001000000000000000001
110000000001111111111100000000000001
1000000000110CCCCCCC0110000000000001
10000000011000M000M000110000000M0001
1000000011000000M0000001100000000001
110011111000000000000000111110011101
100001000000000000000000000100001CC1
100000M0000M0000M0000M0000M0000M1CC1
100001000000000000000000000100001CC1
111111111000000000000000111111101111
1000C00011000000M0000001100000000001
1000M000111000M000M000111C00000000C1
100M0M0000110CCCCCCC011C10000M000001
1000000010011111111111CC100000000001
10M000M010000CC0100CC0001MMMMMMMMMM1
1000M0001000M000M000M0001000CCC00001
111101111111111111101111110111111011
1MMMMMMMMMMMMMMM100000C0000001000001
1001000000000000100M00C00000010M0001
100000M00000000E100000C00000000000C1
1CC1000000000000100000C000M001000CC1
111111111111111111111111111111111111